4
3
3 3
50 50
- - - - - - - - - - - - - - - - - - - - - - - - - - - - - - - - - - - - - - - - - - - - - - - - - -
- - - - - - - - - 0 0 0 0 0 - - - - - - - - - - - - - - - - - - - - - - 0 0 0 0 0 - - - - - - - - -
- - - - - - - 0 0 0 0 0 0 0 0 0 - - - - - - - - - - - - - - - - - - 0 0 0 0 0 0 0 0 0 - - - - - - -
- - - - - 0 0 0 0 0 0 0 0 0 0 0 0 0 - - - - - - - - - - - - - - 0 0 0 0 0 0 0 0 0 0 0 0 0 - - - - -
- - - - 0 0 0 0 0 0 0 0 0 0 0 0 0 0 0 - - - - - - - - - - - - 0 0 0 0 0 0 0 0 0 0 0 0 0 0 0 - - - -
- - - - 0 0 0 0 0 0 2 2 0 0 0 0 0 0 0 0 - - - - - - - - - - 0 0 0 0 0 0 0 0 0 2 2 0 0 0 0 0 - - - -
- - - 0 0 0 0 0 0 0 2 2 0 0 0 0 0 0 0 0 0 - - - - - - - - 0 0 0 0 0 0 0 0 0 0 2 2 0 0 0 0 0 0 - - -
- - 0 0 0 0 0 0 0 0 0 0 0 0 0 0 0 0 0 0 0 - - - - - - - - 0 0 0 0 0 0 0 0 0 0 0 0 0 0 0 0 0 0 0 - -
- - 0 0 0 0 0 0 0 0 0 0 0 0 0 0 0 0 0 0 0 0 - - - - - - 0 0 0 0 0 0 0 0 0 0 0 0 0 0 0 0 0 0 0 0 - -
- - 0 0 0 0 0 0 0 0 0 0 0 0 0 0 0 0 0 0 0 0 - - - - - - 0 0 0 0 0 0 0 0 0 0 0 0 0 0 0 0 0 0 0 0 - -
- - 0 0 0 0 0 0 0 0 0 0 0 0 0 0 0 0 0 0 0 0 0 - - - - 0 0 0 0 0 0 0 0 0 0 0 3 4 0 0 0 0 0 0 0 0 - -
- 0 0 0 0 0 4 1 0 0 0 0 i 0 0 0 0 0 0 3 4 0 0 - - - - 0 0 0 0 2 2 0 0 0 0 0 4 3 0 0 0 0 0 0 0 0 0 -
- 0 0 0 0 0 1 4 0 0 0 0 0 0 0 0 0 0 0 4 3 0 0 - - - - 0 0 0 0 2 2 0 0 0 0 0 0 0 0 0 0 0 0 0 0 0 0 -
- 0 0 0 0 0 0 0 0 0 0 0 0 0 0 0 0 0 0 0 0 0 0 0 - - 0 0 0 0 0 0 0 0 0 0 0 0 0 0 0 0 0 0 0 0 0 0 0 -
- 0 0 0 0 0 0 0 0 0 0 0 0 0 0 0 0 0 0 0 0 0 0 0 0 0 0 0 0 0 0 0 0 0 0 0 0 0 0 0 0 0 0 0 0 0 0 0 0 -
- 0 0 0 0 0 0 0 0 0 0 0 0 0 0 0 0 0 0 0 0 0 0 0 0 0 0 0 0 0 0 0 0 0 0 0 1 3 0 0 0 0 0 0 0 0 0 0 0 -
- 0 0 0 0 0 0 0 0 - - - - 0 0 - - - 0 0 - - 0 0 0 - 0 0 - 0 0 - - - 0 0 3 1 0 0 - 0 0 0 0 0 0 0 0 -
- 0 0 0 0 0 0 0 0 - x i - 0 0 - 0 0 0 - 0 0 - 0 0 - 0 0 - 0 0 - 0 0 - 0 0 0 0 - - 0 0 0 0 0 0 0 0 -
- 0 0 0 0 2 2 0 0 - - - - 0 0 - 0 0 0 - 0 0 - 0 0 - 0 0 - 0 0 - 0 0 - 0 0 0 - b - 0 0 0 0 0 0 0 0 -
- - 0 0 0 2 2 0 0 0 0 0 - 0 0 - 0 0 0 - 0 0 - 0 0 - 0 0 - 0 0 - 0 0 - 0 0 - 0 0 - 0 0 0 0 0 0 0 - -
- - 0 0 0 0 0 0 0 0 - - - 0 0 - 0 0 0 0 - - 0 0 0 0 - - - 0 0 - - - 0 0 0 - - - - - 0 0 0 0 0 0 - -
- - 0 0 0 0 0 0 0 - 0 c - 0 0 0 0 0 0 0 0 0 0 0 0 0 0 0 0 0 0 - 0 0 0 0 0 0 0 0 - 0 0 0 0 0 0 0 - -
- - 0 0 0 0 0 0 0 - - - - 0 0 0 0 0 0 0 0 0 0 0 0 0 0 0 0 0 0 - 0 0 0 0 0 0 0 0 - 0 0 0 0 0 0 0 - -
- - - 0 0 0 3 4 0 0 0 0 0 0 0 0 0 0 0 0 0 0 0 0 0 0 0 0 0 0 0 0 0 0 0 0 0 2 2 0 0 0 0 0 0 0 0 - - -
- - - 0 0 0 4 3 0 0 0 0 0 0 0 0 0 0 0 0 4 1 0 0 0 0 0 0 0 0 2 2 0 0 0 0 0 2 2 0 0 0 0 0 0 0 0 - - -
- - - 0 0 0 0 0 0 i 0 0 0 0 0 0 0 0 0 0 1 4 0 0 0 0 0 0 0 0 2 2 0 0 0 0 0 0 0 0 0 0 0 0 0 0 0 - - -
- - - - 0 0 0 0 0 0 0 0 0 0 - 0 0 0 0 0 0 0 0 0 0 0 0 0 0 0 0 0 0 0 0 0 0 0 0 0 0 0 0 0 0 0 - - - -
- - - - 0 0 0 0 0 1 3 0 0 0 - 0 0 0 0 0 0 0 0 0 0 0 0 0 0 0 0 0 - 0 0 0 0 1 3 0 0 0 0 0 0 0 - - - -
- - - - - 0 0 0 0 3 1 0 0 0 - - - - 0 0 0 - - 0 0 0 0 - - 0 0 - - - 0 0 0 3 1 0 0 0 0 0 0 - - - - -
- - - - - 0 0 0 0 0 0 0 0 0 - x b - 0 0 - c 0 - 0 0 - 0 0 0 0 0 - 0 0 0 0 i 0 0 0 0 0 0 0 - - - - -
- - - - - - 0 0 0 0 0 0 0 0 - x x - 0 0 - - - - 0 0 0 - - 0 0 0 - 0 0 0 0 0 0 0 0 0 0 0 - - - - - -
- - - - - - 0 0 0 0 0 0 0 0 - b x - 0 0 - 0 0 0 0 0 0 0 0 - 0 0 - 0 0 0 0 0 0 0 0 0 0 0 - - - - - -
- - - - - - - 0 0 0 0 0 0 0 - - - - 0 0 0 - - 0 0 0 0 - - 0 0 0 0 - 0 0 0 0 0 0 0 0 0 - - - - - - -
- - - - - - - - 0 0 0 0 0 0 2 2 0 0 0 0 0 0 0 0 0 0 0 0 0 0 0 0 0 0 0 0 0 0 0 0 0 0 - - - - - - - -
- - - - - - - - 0 0 0 0 0 0 2 2 0 0 0 0 0 0 0 0 0 0 0 0 0 0 0 0 0 0 0 0 0 0 0 0 0 0 - - - - - - - -
- - - - - - - - - 0 0 0 0 0 0 0 0 0 0 0 0 0 0 0 0 0 0 0 0 0 0 0 0 0 0 0 0 0 0 0 0 - - - - - - - - -
- - - - - - - - - - 0 0 0 0 0 0 0 0 0 0 0 0 4 1 0 0 0 0 0 0 0 2 2 0 0 0 0 0 0 0 - - - - - - - - - -
- - - - - - - - - - 0 0 0 0 0 0 0 0 0 0 0 0 1 4 0 0 0 0 0 0 0 2 2 0 0 0 0 0 0 0 - - - - - - - - - -
- - - - - - - - - - - 0 0 0 0 0 0 0 0 0 0 0 0 0 0 0 0 0 0 0 0 0 0 0 0 0 0 0 0 - - - - - - - - - - -
- - - - - - - - - - - - 0 0 0 0 0 0 0 0 0 0 0 0 0 0 0 0 0 0 0 0 0 0 0 0 0 0 - - - - - - - - - - - -
- - - - - - - - - - - - - 0 0 0 0 0 0 0 0 0 0 0 0 0 0 0 0 0 0 0 0 0 0 0 0 - - - - - - - - - - - - -
- - - - - - - - - - - - - - 0 0 0 0 0 0 0 0 0 0 0 0 0 0 0 0 0 0 0 0 0 0 - - - - - - - - - - - - - -
- - - - - - - - - - - - - - - 0 0 0 0 0 0 0 0 0 2 2 0 0 0 0 0 0 0 0 0 - - - - - - - - - - - - - - -
- - - - - - - - - - - - - - - - 0 0 0 0 0 0 0 0 2 2 0 0 0 0 0 0 0 0 - - - - - - - - - - - - - - - -
- - - - - - - - - - - - - - - - - 0 0 0 0 0 0 0 0 0 0 0 0 0 0 0 0 - - - - - - - - - - - - - - - - -
- - - - - - - - - - - - - - - - - - - 0 0 0 0 0 0 0 0 0 0 0 0 - - - - - - - - - - - - - - - - - - -
- - - - - - - - - - - - - - - - - - - - 0 0 0 0 0 0 0 0 0 0 - - - - - - - - - - - - - - - - - - - -
- - - - - - - - - - - - - - - - - - - - - - 0 0 0 0 0 0 - - - - - - - - - - - - - - - - - - - - - -
- - - - - - - - - - - - - - - - - - - - - - - - 0 0 - - - - - - - - - - - - - - - - - - - - - - - -
- - - - - - - - - - - - - - - - - - - - - - - - - - - - - - - - - - - - - - - - - - - - - - - - - -
