3
3
0 1
15 27
c 0 0 b - - - - - - - - - - - - - - - - - - - b 0 0 c
0 0 0 0 - - - - - - - - - - - - - - - - - - - 0 0 0 0
0 0 0 0 - - - - - - - - - - - - - - - - - - - 0 0 0 0
0 0 0 0 - - - - - - - - - 0 - - - - - - - - - 0 0 0 0
- - - - - - - - - - - - 0 0 0 - - - - - - - - - - - -
- - - - - - - - - - - 0 0 0 0 0 - - - - - - - - - - -
- - - - - - - - - - 0 0 1 2 3 0 0 - - - - - - - - - -
- - - - - - - - - 0 0 0 3 1 2 0 0 0 - - - - - - - - -
- - - - - - - - - - 0 0 2 3 1 0 0 - - - - - - - - - -
- - - - - - - - - - - 0 0 0 0 0 - - - - - - - - - - -
- - - - - - - - - - - - 0 0 0 - - - - - - - - - - - -
0 0 0 0 - - - - - - - - - 0 - - - - - - - - - c 0 0 0
0 0 0 0 - - - - - - - - - - - - - - - - - - - 0 0 0 0
0 0 0 0 - - - - - - - - - - - - - - - - - - - 0 0 0 0
c 0 0 b - - - - - - - - - - - - - - - - - - - b 0 0 0
13 11 4 <-> 3 11 1
13 3 0 <-> 23 3 5