3
6
4 2
14 15
- - - - - - - 0 - - - - - - -
- - - - - - 0 0 0 - - - - - -
- - - - - - 0 0 0 - - - - - -
- - 0 0 0 - - - - - 0 0 0 - -
- 0 0 0 0 0 - - - 0 0 0 0 0 -
0 0 x x 0 0 0 - 0 0 0 x x 0 0
0 0 x x 0 i 0 0 0 i 0 x x 0 0
- 0 0 i 0 0 1 2 3 0 0 0 0 0 -
- - 0 0 c 0 3 1 2 0 0 c 0 - -
- - - 0 0 0 2 3 1 0 0 0 - - -
- - - - 0 i 0 0 0 i 0 - - - -
- - - - - 0 0 0 0 0 - - - - -
- - - - - - 0 0 0 - - - - - -
- - - - - - - 0 - - - - - - -
7 0 0 <-> 7 13 4
6 5 1 <-> 8 5 7
