2
6
4 2
14 15
- - - - - - - 1 - - - - - - -
- - - - - - 0 2 0 - - - - - -
- - - - - - 0 0 0 - - - - - -
- - 2 1 1 - - - - - 0 0 0 - -
- 0 0 0 0 2 - - - 0 2 0 0 0 -
0 0 x x 0 0 0 - 0 0 2 x x 0 0
0 0 x x 0 i 0 1 2 i 2 x x 0 0
- 0 0 i 0 0 0 0 1 1 1 0 0 0 -
- - 0 0 c 2 1 1 2 2 2 c 2 - -
- - - 0 0 0 1 0 1 0 0 0 - - -
- - - - 0 i 1 0 0 i 0 - - - -
- - - - - 0 1 0 0 0 - - - - -
- - - - - - 1 0 0 - - - - - -
- - - - - - - 0 - - - - - - -
7 0 0 <-> 7 13 4
6 5 1 <-> 8 5 7
