2
6
4 2
14 15
- - - - - - - 1 - - - - - - -
- - - - - - 0 2 0 - - - - - -
- - - - - - 0 0 0 - - - - - -
- - 2 1 1 - - - - - 1 2 1 - -
- 2 2 2 0 2 - - - 0 2 1 2 1 -
1 2 2 1 2 2 2 - 2 0 2 x x 1 0
2 2 2 1 0 b 0 1 2 b 2 x x 1 0
- 1 1 b 0 1 1 1 1 2 1 1 0 1 -
- - 1 1 c 2 1 1 2 2 1 c 2 - -
- - - 0 1 0 1 2 1 1 1 1 - - -
- - - - 2 b 1 0 0 i 2 - - - -
- - - - - 1 1 2 1 1 - - - - -
- - - - - - 1 2 0 - - - - - -
- - - - - - - 2 - - - - - - -
7 0 0 <-> 7 13 4
6 5 1 <-> 8 5 7
