4
2
0 3
13 15
- - - - - - - - - - - - - - -
- - - 0 0 0 0 c 0 0 0 0 - - -
- - 0 0 0 0 0 c 0 0 0 0 0 - -
- 0 0 0 0 4 - - - 1 0 0 0 0 -
- 0 0 0 4 - 4 0 1 - 1 0 0 0 -
- 0 0 4 - 4 4 0 1 1 - 1 0 0 -
- i x c - 0 0 0 0 0 - i x c -
- 0 0 3 - 3 3 0 2 2 - 2 0 0 -
- 0 0 0 3 - 3 0 2 - 2 0 0 0 -
- 0 0 0 0 3 - - - 2 0 0 0 0 -
- - 0 0 0 0 0 c 0 0 0 0 0 - -
- - - 0 0 0 0 c 0 0 0 0 - - -
- - - - - - - - - - - - - - -
2 2 7 <-> 13 6 3
12 2 1 <-> 2 11 5
