4
5
3 3
17 17
- - - - - - - - - - - - - - - - -
- 0 0 0 0 0 0 c - c 0 0 0 0 0 0 -
- 0 1 2 0 0 0 0 0 0 0 0 0 1 2 0 -
- 0 4 3 0 0 0 0 b 0 0 0 0 4 3 0 -
- 0 0 0 0 0 0 0 0 0 0 0 0 0 0 0 -
- 0 0 0 0 0 0 0 - 0 0 0 0 0 0 0 -
- 0 0 0 0 0 x x - x x 0 0 0 0 0 -
- c 0 0 0 0 x x - x x 0 0 0 0 c -
- - 0 b 0 - - - i - - - 0 b 0 - -
- c 0 0 0 0 x x - x x 0 0 0 0 c -
- 0 0 0 0 0 x x - x x 0 0 0 0 0 -
- 0 0 0 0 0 0 0 - 0 0 0 0 0 0 0 -
- 0 0 0 0 0 0 0 0 0 0 0 0 0 0 0 -
- 0 1 2 0 0 0 0 b 0 0 0 0 1 2 0 -
- 0 4 3 0 0 0 0 0 0 0 0 0 4 3 0 -
- 0 0 0 0 0 0 c - c 0 0 0 0 0 0 -
- - - - - - - - - - - - - - - - -
1 1 6 <-> 15 1 2
1 2 6 <-> 15 2 2
1 3 6 <-> 15 3 2
1 4 6 <-> 15 4 2
1 5 6 <-> 15 5 2
1 11 6 <-> 15 11 2
1 12 6 <-> 15 12 2
1 13 6 <-> 15 13 2
1 14 6 <-> 15 14 2
1 15 6 <-> 15 15 2
1 1 0 <-> 1 15 4
2 1 0 <-> 2 15 4
3 1 0 <-> 3 15 4
4 1 0 <-> 4 15 4
5 1 0 <-> 5 15 4
11 1 0 <-> 11 15 4
12 1 0 <-> 12 15 4
13 1 0 <-> 13 15 4
14 1 0 <-> 14 15 4
15 1 0 <-> 15 15 4