8
69
3 6
19 19
- - - - - - - - - - - - - - - - - - -
- 0 0 0 0 0 - 0 0 0 0 0 - 0 0 0 0 0 -
- 0 1 2 3 0 - 0 1 2 3 0 - 0 1 2 3 0 -
- 0 8 x 4 0 - 0 8 x 4 0 - 0 8 x 4 0 -
- 0 7 6 5 0 - 0 7 6 5 0 - 0 7 6 5 0 -
- 0 0 0 0 0 0 0 0 0 0 0 0 0 0 0 0 0 -
- - - - - 0 0 0 - - - 0 0 0 - - - - -
- 0 0 0 0 0 0 0 0 c 0 0 0 0 0 0 0 0 -
- 0 1 2 3 0 - 0 b b b 0 - 0 1 2 3 0 -
- 0 8 x 4 0 - c b i b c - 0 8 x 4 0 -
- 0 7 6 5 0 - 0 b b b 0 - 0 7 6 5 0 -
- 0 0 0 0 0 0 0 0 c 0 0 0 0 0 0 0 0 -
- - - - - 0 0 0 - - - 0 0 0 - - - - -
- 0 0 0 0 0 0 0 0 0 0 0 0 0 0 0 0 0 -
- 0 1 2 3 0 - 0 1 2 3 0 - 0 1 2 3 0 -
- 0 8 x 4 0 - 0 8 x 4 0 - 0 8 x 4 0 -
- 0 7 6 5 0 - 0 7 6 5 0 - 0 7 6 5 0 -
- 0 0 0 0 0 - 0 0 0 0 0 - 0 0 0 0 0 -
- - - - - - - - - - - - - - - - - - -
1 1 7 <-> 18 18 3
1 18 5 <-> 18 1 1
9 1 0 <-> 9 18 4
1 9 6 <-> 18 9 2