8
4
2 4
34 34
- - - - - - - - - - - - - - - - - - - - - - - - - - - - - - - - - -
- 0 0 0 0 0 0 0 0 0 0 - 0 0 0 0 0 0 0 0 0 0 - 0 0 0 0 0 0 0 0 0 0 -
- 0 0 0 0 0 0 0 0 0 0 - 0 0 0 0 0 0 0 0 0 0 - 0 0 0 0 0 0 0 0 0 0 -
- 0 0 0 0 0 0 0 0 0 0 - 0 0 0 0 0 0 0 0 0 0 - 0 0 0 0 0 0 0 0 0 0 -
- 0 0 0 0 0 0 0 0 0 0 - 0 0 0 0 0 0 0 0 0 0 - 0 0 0 0 0 0 0 0 0 0 -
- 0 0 0 0 1 2 0 0 0 0 - 0 0 0 0 2 3 0 0 0 0 - 0 0 0 0 3 4 0 0 0 0 -
- 0 0 0 0 2 1 0 0 0 0 - 0 0 0 0 3 2 0 0 0 0 - 0 0 0 0 4 3 0 0 0 0 -
- 0 0 0 0 0 0 0 0 0 0 - 0 0 0 0 0 0 0 0 0 0 - 0 0 0 0 0 0 0 0 0 0 -
- 0 0 0 0 0 0 0 0 0 0 - 0 0 0 0 0 0 0 0 0 0 - 0 0 0 0 0 0 0 0 0 0 -
- 0 0 0 0 0 0 0 0 0 0 - 0 0 0 0 0 0 0 0 0 0 - 0 0 0 0 0 0 0 0 0 0 -
- 0 0 0 0 0 0 0 0 0 0 - 0 0 0 0 0 0 0 0 0 0 - 0 0 0 0 0 0 0 0 0 0 -
- - - - - - - - - - - - - - - - - - - - - - - - - - - - - - - - - -
- 0 0 0 0 0 0 0 0 0 0 - b b b b b b b b b b - 0 0 0 0 0 0 0 0 0 0 -
- 0 0 0 0 0 0 0 0 0 0 - b 0 0 0 0 0 0 0 0 b - 0 0 0 0 0 0 0 0 0 0 -
- 0 0 0 0 0 0 0 0 0 0 - b 0 0 0 0 0 0 0 0 b - 0 0 0 0 0 0 0 0 0 0 -
- 0 0 0 0 0 0 0 0 0 0 - b 0 0 0 0 0 0 0 0 b - 0 0 0 0 0 0 0 0 0 0 -
- 0 0 0 0 8 1 0 0 0 0 - b 0 0 0 x x 0 0 0 b - 0 0 0 0 4 5 0 0 0 0 -
- 0 0 0 0 1 8 0 0 0 0 - b 0 0 0 x x 0 0 0 b - 0 0 0 0 5 4 0 0 0 0 -
- 0 0 0 0 0 0 0 0 0 0 - b 0 0 0 0 0 0 0 0 b - 0 0 0 0 0 0 0 0 0 0 -
- 0 0 0 0 0 0 0 0 0 0 - b 0 0 0 0 0 0 0 0 b - 0 0 0 0 0 0 0 0 0 0 -
- 0 0 0 0 0 0 0 0 0 0 - b 0 0 0 0 0 0 0 0 b - 0 0 0 0 0 0 0 0 0 0 -
- 0 0 0 0 0 0 0 0 0 0 - b b b b b b b b b b - 0 0 0 0 0 0 0 0 0 0 -
- - - - - - - - - - - - - - - - - - - - - - - - - - - - - - - - - -
- 0 0 0 0 0 0 0 0 0 0 - 0 0 0 0 0 0 0 0 0 0 - 0 0 0 0 0 0 0 0 0 0 -
- 0 0 0 0 0 0 0 0 0 0 - 0 0 0 0 0 0 0 0 0 0 - 0 0 0 0 0 0 0 0 0 0 -
- 0 0 0 0 0 0 0 0 0 0 - 0 0 0 0 0 0 0 0 0 0 - 0 0 0 0 0 0 0 0 0 0 -
- 0 0 0 0 0 0 0 0 0 0 - 0 0 0 0 0 0 0 0 0 0 - 0 0 0 0 0 0 0 0 0 0 -
- 0 0 0 0 7 8 0 0 0 0 - 0 0 0 0 6 7 0 0 0 0 - 0 0 0 0 5 6 0 0 0 0 -
- 0 0 0 0 8 7 0 0 0 0 - 0 0 0 0 7 6 0 0 0 0 - 0 0 0 0 6 5 0 0 0 0 -
- 0 0 0 0 0 0 0 0 0 0 - 0 0 0 0 0 0 0 0 0 0 - 0 0 0 0 0 0 0 0 0 0 -
- 0 0 0 0 0 0 0 0 0 0 - 0 0 0 0 0 0 0 0 0 0 - 0 0 0 0 0 0 0 0 0 0 -
- 0 0 0 0 0 0 0 0 0 0 - 0 0 0 0 0 0 0 0 0 0 - 0 0 0 0 0 0 0 0 0 0 -
- 0 0 0 0 0 0 0 0 0 0 - 0 0 0 0 0 0 0 0 0 0 - 0 0 0 0 0 0 0 0 0 0 -
- - - - - - - - - - - - - - - - - - - - - - - - - - - - - - - - - -