4
2
2 2
8 15
0 - - - - - - - - - - - - - 0
0 0 - - - - - i - - - - - 0 0
0 0 0 - - - 0 0 0 - - - 0 0 0
0 0 0 0 - 0 0 0 0 0 - 0 0 0 0
0 0 0 0 c 0 0 4 0 0 c 0 0 0 0
0 1 2 0 0 0 1 2 3 0 0 0 3 4 0
0 3 4 0 0 0 0 4 0 0 0 0 1 2 0
0 0 0 0 0 0 0 b 0 0 0 0 0 0 0
0 0 7 <-> 14 7 3
0 7 5 <-> 14 0 1