4
2
2 2
8 15
0 - - - - - - - - - - - - - 0
0 0 - - - - - i - - - - - 0 0
0 0 0 - - - 0 0 0 - - - 0 0 0
0 0 0 0 - 0 0 0 0 0 - 0 0 0 0
0 0 0 0 c 0 0 b 0 0 c 0 0 0 0
0 1 2 0 x x x x x x x 0 3 4 0
0 3 4 0 0 0 0 0 0 0 0 0 1 2 0
0 0 0 0 0 0 0 b 0 0 0 0 0 0 0
0 0 7 <-> 14 7 3