3 Spieler
3
0
1
15 27
c 0 0 b - - - - - - - - - - - - - - - - - - - b 0 0 c
0 0 0 0 - - - - - - - - - - - - - - - - - - - 0 0 0 0
0 0 0 0 - - - - - - - - - - - - - - - - - - - 0 0 0 0
0 0 0 0 - - - - - - - - - 0 - - - - - - - - - 0 0 0 0
- - - - - - - - - - - - 0 0 0 - - - - - - - - - - - -
- - - - - - - - - - - 0 0 0 0 0 - - - - - - - - - - -
- - - - - - - - - - 0 0 1 2 3 0 0 - - - - - - - - - -
- - - - - - - - - 0 0 0 3 1 2 0 0 0 - - - - - - - - -
- - - - - - - - - - 0 0 2 3 1 0 0 - - - - - - - - - -
- - - - - - - - - - - 0 0 0 0 0 - - - - - - - - - - -
- - - - - - - - - - - - 0 0 0 - - - - - - - - - - - -
0 0 0 0 - - - - - - - - - 0 - - - - - - - - - c 0 0 0
0 0 0 0 - - - - - - - - - - - - - - - - - - - 0 0 0 0
0 0 0 0 - - - - - - - - - - - - - - - - - - - 0 0 0 0
c 0 0 b - - - - - - - - - - - - - - - - - - - b 0 0 0
14 12 4 <-> 4 12 5
14 4 0 <-> 24 4 1