4
2
0 3
15 15
- - - - - - - - - - - - - - -
- - - 0 0 0 0 i 0 0 0 0 - - -
- - 0 0 0 0 0 x 0 0 0 0 0 - -
- 0 0 0 0 0 - - - 0 0 0 0 0 -
- 0 0 0 0 - 4 i 1 - 0 0 0 0 -
- 0 0 0 - 4 4 x 1 1 - 0 0 0 -
- c i x - i x c i x - i x c -
- 0 0 0 - 3 3 i 2 2 - 0 0 0 -
- 0 0 0 c - 3 x 2 - 0 0 0 0 -
- 0 0 0 0 0 - - - 0 0 0 0 0 -
- - 0 0 0 0 0 i 0 0 0 0 0 - -
- - - 0 0 0 0 x 0 0 0 0 - - -
- - - - - - - - - - - - - - -
- 0 0 0 0 - - - - - 0 0 0 0 -
- 0 0 0 0 - - - - - 0 0 0 0 -
2 2 7 <-> 13 6 2
2 2 0 <-> 12 10 2
1 14 6 <-> 13 13 2
