2
0
0 0
14 14
- x b 0 0 0 0 0 0 0 0 b x - 
x - 0 0 0 0 0 0 0 0 0 0 - x 
b 0 - 0 0 0 0 0 0 0 0 - 0 b 
0 0 0 - 0 0 0 0 0 0 - 0 0 0 
0 0 0 0 c 0 0 0 0 c 0 0 0 0 
0 0 0 0 0 0 0 0 0 0 0 0 0 0 
0 0 0 0 0 0 2 1 0 0 0 0 0 0 
0 0 0 0 0 0 1 2 0 0 0 0 0 0 
0 0 0 0 0 0 0 0 0 0 0 0 0 0 
0 0 0 0 c 0 0 0 0 c 0 0 0 0 
0 0 0 - 0 0 0 0 0 0 - 0 0 0 
b 0 - 0 0 0 0 0 0 0 0 - 0 b 
x - 0 0 0 0 0 0 0 0 0 0 - x 
- x b 0 0 0 0 0 0 0 0 b x - 
