8
0
1 2
52 52
- - - - - - - - - - - - - - - - - - - - - - - - - - - - - - - - - - - - - - - - - - - - - - - - - - - - 
- - - - - - - - - - - - - 0 i 0 0 0 - - - - - - 0 0 0 b 0 - - - - - - 0 0 0 i 0 - - - - - - - - - - - - 
- - - - - - - - - - - - - 0 - - - 0 - - - - - - 0 - - - 0 - - - - - - 0 - - - 0 - - - - - - - - - - - - 
- - - - - - - - - - - - - 0 - - - 0 - - - - - - 0 - - - 0 - - - - - - 0 - - - 0 - - - - - - - - - - - - 
- - - - - - - - - - - - - 0 - - - 0 - - - - - - 0 - - - 0 - - - - - - 0 - - - 0 - - - - - - - - - - - - 
- - - - - 0 0 0 0 0 0 0 0 0 0 - 0 0 0 0 0 0 0 0 0 0 - 0 0 0 0 0 0 0 0 0 0 - 0 0 0 0 0 0 0 0 0 0 - - - - 
- - - - - 0 0 0 0 0 0 0 0 0 0 - 0 0 0 0 0 0 0 0 0 0 - 0 0 0 0 0 0 0 0 0 0 - 0 0 0 0 0 0 0 0 0 0 - - - - 
- - - - - 0 0 0 0 0 0 0 0 0 0 - 0 0 0 0 0 0 0 0 0 0 - 0 0 0 0 0 0 0 0 0 0 - 0 0 0 0 0 0 0 0 0 0 - - - - 
- - - - - 0 0 0 0 0 0 0 0 0 0 - 0 0 0 0 0 0 0 0 0 0 - 0 0 0 0 0 0 0 0 0 0 - 0 0 0 0 0 0 0 0 0 0 - - - - 
- - - - - 0 0 0 0 1 2 0 0 0 0 - 0 0 0 0 2 6 0 0 0 0 - 0 0 0 0 2 3 0 0 0 0 - 0 0 0 0 4 8 0 0 0 0 - - - - 
- - - - - 0 0 0 0 2 1 0 0 0 0 - 0 0 0 0 6 2 0 0 0 0 - 0 0 0 0 3 2 0 0 0 0 - 0 0 0 0 8 4 0 0 0 0 - - - - 
- - - - - 0 0 0 0 0 0 0 0 0 0 - 0 0 0 0 0 0 0 0 0 0 - 0 0 0 0 0 0 0 0 0 0 - 0 0 0 0 0 0 0 0 0 0 - - - - 
- - - - - 0 0 0 0 0 0 0 0 0 0 - 0 0 0 0 0 0 0 0 0 0 - 0 0 0 0 0 0 0 0 0 0 - 0 0 0 0 0 0 0 0 0 0 - - - - 
- 0 0 0 0 0 0 0 0 0 0 0 0 0 0 - 0 0 0 0 0 0 0 0 0 0 - 0 0 0 0 0 0 0 0 0 0 - 0 0 0 0 0 0 0 0 0 0 0 0 0 0 
- i - - - 0 0 0 0 0 0 0 0 0 0 - 0 0 0 0 0 0 0 0 0 0 - 0 0 0 0 0 0 0 0 0 0 - 0 0 0 0 0 0 0 0 0 0 - - - b 
- 0 - - - - - - - - - - - - - - - - - - - - - - - - - - - - - - - - - - - - - - - - - - - - - - - - - 0 
- 0 - - - 0 0 0 0 0 0 0 0 0 0 - 0 0 0 0 0 0 0 0 0 0 0 0 0 0 0 0 0 0 0 0 0 - 0 0 0 0 0 0 0 0 0 0 - - - 0 
- 0 0 0 0 0 0 0 0 0 0 0 0 0 0 - 0 0 0 0 0 0 0 0 0 0 0 0 0 0 0 0 0 0 0 0 0 - 0 0 0 0 0 0 0 0 0 0 0 0 0 0 
- - - - - 0 0 0 0 0 0 0 0 0 0 - 0 0 0 0 0 0 0 0 0 0 0 0 0 0 0 0 0 0 0 0 0 - 0 0 0 0 0 0 0 0 0 0 - - - - 
- - - - - 0 0 0 0 0 0 0 0 0 0 - 0 0 0 0 0 0 0 0 0 0 0 0 0 0 0 0 0 0 0 0 0 - 0 0 0 0 0 0 0 0 0 0 - - - - 
- - - - - 0 0 0 0 4 6 0 0 0 0 - 0 0 0 0 0 0 0 0 0 0 0 0 0 0 0 0 0 0 0 0 0 - 0 0 0 0 1 7 0 0 0 0 - - - - 
- - - - - 0 0 0 0 6 4 0 0 0 0 - 0 0 0 0 0 0 0 0 0 0 0 0 0 0 0 0 0 0 0 0 0 - 0 0 0 0 7 1 0 0 0 0 - - - - 
- - - - - 0 0 0 0 0 0 0 0 0 0 - 0 0 0 0 0 0 0 0 0 0 0 0 0 0 0 0 0 0 0 0 0 - 0 0 0 0 0 0 0 0 0 0 - - - - 
- - - - - 0 0 0 0 0 0 0 0 0 0 - 0 0 0 0 0 0 0 0 0 0 0 0 0 0 0 0 0 0 0 0 0 - 0 0 0 0 0 0 0 0 0 0 - - - - 
- 0 0 0 0 0 0 0 0 0 0 0 0 0 0 - 0 0 0 0 0 0 0 0 0 0 i 0 0 0 0 0 0 0 0 0 0 - 0 0 0 0 0 0 0 0 0 0 0 0 0 0 
- 0 - - - 0 0 0 0 0 0 0 0 0 0 - 0 0 0 0 0 0 0 0 0 b b b 0 0 0 0 0 0 0 0 0 - 0 0 0 0 0 0 0 0 0 0 - - - 0 
- 0 - - - - - - - - - - - - - - 0 0 0 0 0 0 0 0 c b b b c 0 0 0 0 0 0 0 0 - - - - - - - - - - - - - - c 
- c - - - 0 0 0 0 0 0 0 0 0 0 - 0 0 0 0 0 0 0 0 0 b b b 0 0 0 0 0 0 0 0 0 - 0 0 0 0 0 0 0 0 0 0 - - - 0 
- 0 0 0 0 0 0 0 0 0 0 0 0 0 0 - 0 0 0 0 0 0 0 0 0 0 i 0 0 0 0 0 0 0 0 0 0 - 0 0 0 0 0 0 0 0 0 0 0 0 0 0 
- - - - - 0 0 0 0 0 0 0 0 0 0 - 0 0 0 0 0 0 0 0 0 0 0 0 0 0 0 0 0 0 0 0 0 - 0 0 0 0 0 0 0 0 0 0 - - - - 
- - - - - 0 0 0 0 0 0 0 0 0 0 - 0 0 0 0 0 0 0 0 0 0 0 0 0 0 0 0 0 0 0 0 0 - 0 0 0 0 0 0 0 0 0 0 - - - - 
- - - - - 0 0 0 0 1 4 0 0 0 0 - 0 0 0 0 0 0 0 0 0 0 0 0 0 0 0 0 0 0 0 0 0 - 0 0 0 0 5 8 0 0 0 0 - - - - 
- - - - - 0 0 0 0 4 1 0 0 0 0 - 0 0 0 0 0 0 0 0 0 0 0 0 0 0 0 0 0 0 0 0 0 - 0 0 0 0 8 5 0 0 0 0 - - - - 
- - - - - 0 0 0 0 0 0 0 0 0 0 - 0 0 0 0 0 0 0 0 0 0 0 0 0 0 0 0 0 0 0 0 0 - 0 0 0 0 0 0 0 0 0 0 - - - - 
- - - - - 0 0 0 0 0 0 0 0 0 0 - 0 0 0 0 0 0 0 0 0 0 0 0 0 0 0 0 0 0 0 0 0 - 0 0 0 0 0 0 0 0 0 0 - - - - 
- 0 0 0 0 0 0 0 0 0 0 0 0 0 0 - 0 0 0 0 0 0 0 0 0 0 0 0 0 0 0 0 0 0 0 0 0 - 0 0 0 0 0 0 0 0 0 0 0 0 0 0 
- 0 - - - 0 0 0 0 0 0 0 0 0 0 - 0 0 0 0 0 0 0 0 0 0 0 0 0 0 0 0 0 0 0 0 0 - 0 0 0 0 0 0 0 0 0 0 - - - 0 
- i - - - - - - - - - - - - - - - - - - - - - - - - - - - - - - - - - - - - - - - - - - - - - - - - - c 
- 0 - - - 0 0 0 0 0 0 0 0 0 0 - 0 0 0 0 0 0 0 0 0 0 - 0 0 0 0 0 0 0 0 0 0 - 0 0 0 0 0 0 0 0 0 0 - - - 0 
- 0 0 0 0 0 0 0 0 0 0 0 0 0 0 - 0 0 0 0 0 0 0 0 0 0 - 0 0 0 0 0 0 0 0 0 0 - 0 0 0 0 0 0 0 0 0 0 0 0 0 0 
- - - - - 0 0 0 0 0 0 0 0 0 0 - 0 0 0 0 0 0 0 0 0 0 - 0 0 0 0 0 0 0 0 0 0 - 0 0 0 0 0 0 0 0 0 0 - - - - 
- - - - - 0 0 0 0 0 0 0 0 0 0 - 0 0 0 0 0 0 0 0 0 0 - 0 0 0 0 0 0 0 0 0 0 - 0 0 0 0 0 0 0 0 0 0 - - - - 
- - - - - 0 0 0 0 7 5 0 0 0 0 - 0 0 0 0 7 3 0 0 0 0 - 0 0 0 0 8 3 0 0 0 0 - 0 0 0 0 5 6 0 0 0 0 - - - - 
- - - - - 0 0 0 0 5 7 0 0 0 0 - 0 0 0 0 3 7 0 0 0 0 - 0 0 0 0 3 8 0 0 0 0 - 0 0 0 0 6 5 0 0 0 0 - - - - 
- - - - - 0 0 0 0 0 0 0 0 0 0 - 0 0 0 0 0 0 0 0 0 0 - 0 0 0 0 0 0 0 0 0 0 - 0 0 0 0 0 0 0 0 0 0 - - - - 
- - - - - 0 0 0 0 0 0 0 0 0 0 - 0 0 0 0 0 0 0 0 0 0 - 0 0 0 0 0 0 0 0 0 0 - 0 0 0 0 0 0 0 0 0 0 - - - - 
- - - - - 0 0 0 0 0 0 0 0 0 0 - 0 0 0 0 0 0 0 0 0 0 - 0 0 0 0 0 0 0 0 0 0 - 0 0 0 0 0 0 0 0 0 0 - - - - 
- - - - - 0 0 0 0 0 0 0 0 0 0 - 0 0 0 0 0 0 0 0 0 0 - 0 0 0 0 0 0 0 0 0 0 - 0 0 0 0 0 0 0 0 0 0 - - - - 
- - - - - - - - - - - - - 0 - - - 0 - - - - - - 0 - - - 0 - - - - - - 0 - - - 0 - - - - - - - - - - - - 
- - - - - - - - - - - - - 0 - - - 0 - - - - - - 0 - - - 0 - - - - - - 0 - - - 0 - - - - - - - - - - - - 
- - - - - - - - - - - - - 0 - - - 0 - - - - - - 0 - - - 0 - - - - - - 0 - - - 0 - - - - - - - - - - - - 
- - - - - - - - - - - - - 0 0 c 0 0 - - - - - - 0 b 0 0 0 - - - - - - 0 0 0 b 0 - - - - - - - - - - - - 
26 1 0 <-> 37 1 0
1 26 2 <-> 1 36 6
15 51 4 <-> 26 51 4
37 51 4 <-> 51 37 2
51 26 2 <-> 51 15 2
16 1 5 <-> 1 16 1
