2
0
0 0
8 9
- - - - - - - - - 
- - 2 - - - 2 - - 
- 2 2 2 0 2 2 2 - 
- - 2 - - - 2 - - 
- - 2 - - - 2 - - 
- - 2 - - - 2 - - 
- - 1 - - - 1 - - 
- - - - - - - - - 
7 2 2 <-> 2 1 0
1 2 6 <-> 6 1 0
