4
2
2 2
23 23
0 i 0 0 0 0 0 0 0 0 0 0 0 0 0 0 0 0 0 0 0 0 0 
0 0 0 0 0 0 0 0 0 0 0 0 0 0 0 0 0 0 0 0 0 0 0 
0 0 0 0 0 - - - - i - - - - - - - - 0 0 0 0 0 
- 0 0 0 0 0 - - 0 - 0 - - - - - - 0 0 0 0 0 - 
- 0 0 0 0 0 0 0 - - - 0 - - - - 0 0 0 0 0 - - 
- 0 - 0 0 0 0 0 - - - - 0 - - 0 0 0 0 0 - - - 
- 0 - - 0 0 0 0 1 - - 1 - - 0 0 0 0 0 - - - - 
- 0 - - - 0 0 0 1 1 2 - - 3 3 0 0 0 - - - - - 
- 0 - - - - 0 0 0 2 2 - 2 3 0 0 0 0 - - - - - 
- 0 - - - 0 - 0 0 2 2 4 3 0 0 0 - 0 - - - - - 
- 0 - - 0 - - - 0 0 4 4 4 0 c - - 0 - - - - - 
- 0 - 0 - - - - - 0 0 4 0 0 0 0 0 0 - - - - - 
- 0 0 - - - - - 0 0 0 0 0 0 0 - - 0 - - - - - 
- 0 c 0 0 0 0 0 0 0 0 0 0 0 0 0 - 0 - - - - - 
- - - - - - 0 0 0 0 0 i 0 0 0 x x x - - - - - 
- - - - - 0 0 0 0 0 - 0 - 0 0 x x 0 - - - - - 
- - - - 0 0 0 0 0 - - 0 - - 0 0 0 0 0 - - - - 
- - - 0 0 0 0 0 - - - 0 - - - 0 0 0 0 0 - - - 
- - 0 0 0 0 0 - - - - 0 - - - - 0 0 0 0 0 - - 
- 0 0 0 0 0 - - - - - 0 - - - - - 0 0 0 0 0 - 
0 0 0 0 0 - - - - - - x - - - - - - 0 0 0 0 0 
0 0 b 0 0 0 0 0 0 0 x x x 0 0 0 0 0 0 0 0 0 0 
0 0 0 0 0 0 0 0 0 0 0 0 0 0 0 0 0 0 0 0 0 0 0 
8 3 3 <-> 22 22 3
10 3 2 <-> 1 13 4
9 11 6 <-> 15 11 1
11 20 1 <-> 18 22 4
4 2 2 <-> 17 11 2
