4
2
0 0
13 49
- - - - - - - - - 0 0 - 0 0 0 0 0 0 0 0 0 - - - - - - - - - - 0 0 0 0 - - - - - - - - - - - - - - 
- 0 0 0 0 0 0 0 0 0 0 0 0 0 0 0 0 0 0 0 - - - 0 0 0 0 1 3 0 0 0 0 0 0 0 0 0 0 0 0 0 0 0 0 - - - - 
0 0 0 0 0 0 2 0 0 0 0 0 0 0 0 - b - - - 0 0 0 0 0 0 1 2 3 3 1 3 2 2 4 0 4 0 0 0 0 0 0 0 0 - - - - 
- - - 0 0 0 3 2 4 0 0 0 0 0 0 - - - - - 0 0 0 0 0 3 1 2 1 1 1 3 4 2 2 4 4 2 0 0 0 0 0 0 - - - - - 
- - - 0 0 0 4 1 3 1 0 - - - - - - - - - 0 0 0 0 0 3 1 2 2 1 1 3 4 2 2 2 2 4 0 0 0 0 0 0 - - - - - 
- - - - 0 0 4 2 3 0 0 0 - - - - - - - 0 0 0 0 0 0 1 3 1 3 2 2 2 4 0 0 0 0 4 4 0 0 0 - - - - - - - 
- - - - - - 0 0 0 0 0 0 0 0 - - - - - 0 0 0 0 0 0 3 2 3 1 0 0 - - - 0 0 - 0 4 0 0 0 0 - - - - - - 
- - - - - - - - - 0 0 0 0 0 0 0 0 - - - 0 0 0 0 0 0 0 0 0 0 - - - - - - - - 0 0 0 0 0 0 0 0 0 - - 
- - - - - - - - - 0 0 0 0 0 0 0 0 - - - - - - - 0 x x 0 0 0 0 - - - - - - - - 0 0 0 0 0 0 0 0 - - 
- - - - - - - - - - 0 0 0 0 0 0 - - - - - - - - 0 x x 0 0 0 - - - - - - - - - - 0 0 0 0 0 0 0 - - 
- - - - - - - - - - - 0 0 0 0 - - - - - - - - - 0 0 0 - - - - - - - - - - - - - 0 0 0 0 0 0 - b 0 
- - - - - - - - - - - 0 0 - - - - - - - - - - - - - - - - - - - - - - - - - - - - - - 0 0 - - - - 
- - - - - - - - - - - - 0 - - - - - - - - - - - - - - - - - - - - - - - - - - - - - - - - - - - - 
46 8 2 <-> 48 10 2
48 10 3 <-> 12 12 4
0 2 6 <-> 44 2 2
1 1 6 <-> 44 1 2
0 2 7 <-> 44 1 3
44 2 1 <-> 1 1 7
16 7 2 <-> 19 6 5
14 3 2 <-> 20 3 6
