4
6
4 0
40 40
0 0 0 0 0 - - - - - - - - - - - - - 0 0 0 0 - - - - - - - - - - - - - 0 0 0 0 0 
0 0 0 0 0 0 - - - - - - - - - - - - 0 0 0 0 - - - - - - - - - - - - 0 0 0 0 0 0 
0 0 x 0 x 0 0 - - - - - - - - - - - 0 0 0 0 - - - - - - - - - - - 0 0 x 0 x 0 0 
0 0 0 x 0 0 0 0 - - - - - - - - - - 0 0 0 0 - - - - - - - - - - 0 0 0 0 x 0 0 0 
0 0 x 0 x 0 0 0 0 0 0 0 0 0 0 0 0 0 0 0 0 0 0 0 0 0 0 0 0 0 0 0 0 0 0 x 0 x 0 0 
- 0 0 0 0 0 0 0 0 0 0 0 0 0 0 0 0 0 0 0 0 0 0 0 0 0 0 0 0 0 0 0 0 0 0 0 0 0 0 - 
- - 0 0 0 0 0 0 0 0 0 0 0 0 0 0 0 0 0 0 0 0 0 0 0 0 0 0 0 0 0 0 0 0 0 0 0 0 - - 
- - - 0 0 0 0 0 0 0 0 0 0 0 0 0 0 0 0 0 0 0 0 0 0 0 0 0 0 0 0 0 0 0 0 0 0 - - - 
- - - - 0 0 0 0 0 0 0 0 0 - - - - - 0 0 0 0 - - - - - 0 0 0 0 0 0 0 0 0 - - - - 
- - - - 0 0 0 0 0 0 0 0 0 0 - - - - 0 0 0 0 - - - - 0 0 0 0 c 0 0 0 0 0 - - - - 
- - - - 0 0 0 0 0 0 0 0 0 0 0 - - - 0 b b 0 - - - 0 0 0 0 0 0 0 0 0 0 0 - - - - 
- - - - 0 0 0 0 0 0 0 0 0 0 0 0 - - 0 0 0 0 - - 0 0 0 0 0 0 0 0 0 0 0 0 - - - - 
- - - - 0 0 0 0 0 0 0 0 0 0 0 0 0 - 0 0 0 0 - 0 0 0 0 i 0 0 0 0 0 0 0 0 - - - - 
- - - - 0 0 0 0 - 0 0 0 0 0 0 0 0 0 0 0 0 0 0 0 0 0 0 0 0 0 0 - 0 0 0 0 - - - - 
- - - - 0 0 0 0 - - 0 0 0 0 0 0 0 0 0 0 0 0 0 0 0 0 0 0 0 0 - - 0 0 0 0 - - - - 
- - - - 0 0 0 0 - - - 0 0 0 0 0 0 0 0 0 0 0 0 0 0 0 0 0 0 - - - 0 0 0 0 - - - - 
- - - - 0 0 0 0 - - - - 0 0 0 0 0 0 0 0 0 0 0 0 0 0 0 0 - - - - 0 0 0 0 - - - - 
- - - - 0 0 0 0 - - - - - 0 0 0 0 0 0 0 0 0 0 0 0 0 0 - - - - - 0 0 0 0 - - - - 
0 0 0 0 0 0 0 0 0 0 0 0 0 0 0 0 0 0 1 2 3 4 0 0 0 0 0 0 0 0 0 0 0 0 0 0 0 0 0 0 
0 0 0 0 0 0 0 0 0 0 b 0 0 0 0 0 0 0 4 1 2 3 0 0 0 0 0 0 0 b 0 0 0 0 0 0 0 0 0 0 
0 0 0 0 0 0 0 0 0 0 b 0 0 0 0 0 0 0 3 4 1 2 0 0 0 0 0 0 0 b 0 0 0 0 0 0 0 0 0 0 
0 0 0 0 0 0 0 0 0 0 0 0 0 0 0 0 0 0 2 3 4 1 0 0 0 0 0 0 0 0 0 0 0 0 0 0 0 0 0 0 
- - - - 0 0 0 0 - - - - - 0 0 0 0 0 0 0 0 0 0 0 0 0 0 - - - - - 0 0 0 0 - - - - 
- - - - 0 0 0 0 - - - - 0 0 0 0 0 0 0 0 0 0 0 0 0 0 0 0 - - - - 0 0 0 0 - - - - 
- - - - 0 0 0 0 - - - 0 0 0 0 0 0 0 0 0 0 0 0 0 0 0 0 0 0 - - - 0 0 0 0 - - - - 
- - - - 0 0 0 0 - - 0 0 0 0 0 0 0 0 0 0 0 0 0 0 0 0 0 0 0 0 - - 0 0 0 0 - - - - 
- - - - 0 0 0 0 - 0 0 0 0 0 0 0 0 0 0 0 0 0 0 0 0 0 0 0 0 0 0 - 0 0 0 0 - - - - 
- - - - 0 0 0 0 0 0 0 0 i 0 0 0 0 - 0 0 0 0 - 0 0 0 0 0 0 0 0 0 0 0 0 0 - - - - 
- - - - 0 0 0 0 0 0 0 0 0 0 0 0 - - 0 0 0 0 - - 0 0 0 0 0 0 0 0 0 0 0 0 - - - - 
- - - - 0 0 0 0 0 0 0 0 0 0 0 - - - 0 b b 0 - - - 0 0 0 0 0 0 0 0 0 0 0 - - - - 
- - - - 0 0 0 0 0 c 0 0 0 0 - - - - 0 0 0 0 - - - - 0 0 0 0 0 0 0 0 0 0 - - - - 
- - - - 0 0 0 0 0 0 0 0 0 - - - - - 0 0 0 0 - - - - - 0 0 0 0 0 0 0 0 0 - - - - 
- - - 0 0 0 0 0 0 0 0 0 0 0 0 0 0 0 0 0 0 0 0 0 0 0 0 0 0 0 0 0 0 0 0 0 0 - - - 
- - 0 0 0 0 0 0 0 0 0 0 0 0 0 0 0 0 0 0 0 0 0 0 0 0 0 0 0 0 0 0 0 0 0 0 0 0 - - 
- 0 0 0 0 0 0 0 0 0 0 0 0 0 0 0 0 0 0 0 0 0 0 0 0 0 0 0 0 0 0 0 0 0 0 0 0 0 0 - 
0 0 x 0 x 0 0 0 0 0 0 0 0 0 0 0 0 0 0 0 0 0 0 0 0 0 0 0 0 0 0 0 0 0 0 x 0 x 0 0 
0 0 0 x 0 0 0 0 - - - - - - - - - - 0 0 0 0 - - - - - - - - - - 0 0 0 0 x 0 0 0 
0 0 x 0 x 0 0 - - - - - - - - - - - 0 0 0 0 - - - - - - - - - - - 0 0 x 0 x 0 0 
0 0 0 0 0 0 - - - - - - - - - - - - 0 0 0 0 - - - - - - - - - - - - 0 0 0 0 0 0 
0 0 0 0 0 - - - - - - - - - - - - - 0 0 0 0 - - - - - - - - - - - - - 0 0 0 0 0 
0 0 7 <-> 39 39 3
0 0 0 <-> 39 39 4
0 0 6 <-> 39 39 2
39 0 1 <-> 0 39 5
39 0 2 <-> 0 39 6
39 0 0 <-> 0 39 4
38 0 0 <-> 38 39 4
37 0 0 <-> 37 39 4
36 0 0 <-> 36 39 4
35 0 0 <-> 35 39 4
1 0 0 <-> 1 39 4
2 0 0 <-> 2 39 4
3 0 0 <-> 3 39 4
4 0 0 <-> 4 39 4
18 0 0 <-> 18 39 4
19 0 0 <-> 19 39 4
20 0 0 <-> 20 39 4
21 0 0 <-> 21 39 4
39 1 2 <-> 0 1 6
39 2 2 <-> 0 2 6
39 3 2 <-> 0 3 6
39 4 2 <-> 0 4 6
39 35 2 <-> 0 35 6
39 36 2 <-> 0 36 6
39 37 2 <-> 0 37 6
39 38 2 <-> 0 38 6
39 18 2 <-> 0 18 6
39 19 2 <-> 0 19 6
0 20 6 <-> 39 20 2
39 21 2 <-> 0 21 6
