2
1
0 0
11 13
c 0 0 0 0 x 0 x 0 0 0 0 c 
0 i 0 0 0 x 0 x 0 0 0 i 0 
b 0 - - - - - - - - - 0 b 
0 0 - - - 0 0 0 - - - 0 0 
x x - - 0 1 2 1 0 - - x x 
0 0 - - 0 2 1 2 0 - - 0 0 
x x - - 0 1 2 1 0 - - x x 
0 0 - - - 0 0 0 - - - 0 0 
b 0 - - - - - - - - - 0 b 
0 i 0 0 0 x 0 x 0 0 0 i 0 
c 0 0 0 0 x 0 x 0 0 0 0 c 
8 5 2 <-> 11 5 6
6 7 4 <-> 6 9 0
1 5 2 <-> 4 5 6
6 3 0 <-> 6 1 4
7 4 1 <-> 11 1 5
7 6 3 <-> 11 9 7
1 9 1 <-> 5 6 5
5 4 7 <-> 1 1 3
