2
2
4 1
36 46
- - - 0 0 0 0 0 - - - - - - - - - - - - - - - - - - - - - - - - - - - - - - - - - 0 0 0 0 0 
- - - 0 0 0 0 0 0 0 - - - - - - - - - - - - - - - - - - - - - - - - - - - - - - 0 0 0 0 0 0 
- - - 0 0 0 0 0 0 0 0 - - - - - - - - - - - - - - - - - - - - - - - - - - - - 0 0 0 0 0 0 - 
- - - - 0 0 0 0 0 0 0 0 - - - - - - - - - - - - - - - - - - - - - - - - - 0 0 0 0 0 0 0 0 - 
- - - - - 0 0 0 0 0 0 0 0 - - - - - - - - - - - - - - - - - - - - - - - 0 0 0 0 0 0 0 0 - - 
- - - - - 0 0 0 b 0 0 0 0 - - - - - - - - - - - - - - - - - - - - - - 0 0 0 0 i 0 0 0 0 - - 
- - - - - 0 0 0 0 0 0 0 0 0 - - - - - - - - - - - - - - - - - - - - 0 0 0 0 0 0 0 0 0 - - - 
- - - - - - 0 0 0 0 0 0 0 0 0 - - - - - - - - - - - - - - - - - - 0 0 0 0 0 0 0 0 0 0 - - - 
- - - - - - 0 0 0 0 0 0 0 0 0 0 - - - - - - - - - - - - - - - - 0 0 0 0 0 0 0 0 0 0 - - - - 
- - - - - - - 0 0 0 0 0 0 0 0 0 0 - - - - - - - - - - - - - - 0 0 0 0 0 0 0 0 0 0 - - - - - 
- - - - - - - 0 0 0 0 0 0 0 0 0 0 0 - - - - - 0 0 0 - - - - 0 0 0 0 0 0 0 0 0 0 0 - - - - - 
- - - - - - - 0 0 0 0 0 0 0 0 0 0 0 0 0 0 0 0 0 0 0 0 0 0 0 0 0 0 0 0 0 0 0 0 0 - - - - - - 
- - - - - - - - 0 0 0 0 0 0 0 0 0 0 0 0 0 0 0 0 0 0 0 0 0 0 0 0 0 0 0 0 0 0 0 0 - - - - - - 
- - - - - - - - 0 0 0 0 0 0 0 0 0 0 0 0 0 0 0 1 2 0 0 0 0 0 0 0 0 0 0 0 0 0 0 - - - - - - - 
- - - - - - - 0 0 0 0 0 0 0 0 0 0 0 0 0 0 0 0 2 1 0 0 0 0 0 0 0 0 0 0 0 0 0 0 - - - - - - - 
- - - - - - 0 0 0 0 0 0 0 0 0 0 0 0 0 0 0 0 0 0 0 0 0 0 0 0 0 0 0 0 0 0 0 0 0 0 - - - - - - 
- - - - - 0 0 0 0 0 0 x x x - 0 0 0 0 0 0 0 0 0 0 0 0 0 0 0 0 x x x - - 0 0 0 0 0 - - - - - 
- - - - 0 0 0 0 0 0 x x x x - - 0 0 0 0 0 0 0 0 0 0 0 0 0 0 x x x - - - - 0 0 0 0 0 - - - - 
- - - 0 0 0 0 0 0 0 x x - - - - - 0 0 0 0 0 0 0 0 0 0 0 0 0 x x x - - - - 0 0 0 0 0 0 - - - 
- - - 0 0 0 0 0 0 0 - - - - - - 0 0 0 0 0 0 0 0 0 0 0 0 0 0 0 - - - - - 0 0 0 0 0 0 0 0 - - 
- - 0 0 0 0 0 0 0 0 0 - - - - 0 0 0 0 0 0 0 0 0 0 0 0 0 0 0 0 0 - - - 0 0 0 0 0 0 0 0 0 - - 
- - 0 0 0 0 0 0 0 0 0 0 0 0 0 0 0 0 0 0 0 0 0 0 0 0 0 0 0 0 0 0 0 0 0 0 0 0 0 0 0 0 0 0 - - 
- - 0 0 0 0 0 0 0 0 0 0 0 0 0 0 0 0 0 0 0 0 0 0 0 0 0 0 0 0 0 0 0 0 0 0 0 0 0 0 0 0 0 0 - - 
- - 0 0 0 0 0 0 0 0 0 0 0 0 0 0 0 0 0 0 - - - - - 0 0 0 0 0 0 0 0 0 0 0 0 0 0 0 0 0 0 0 - - 
- - 0 0 0 0 0 0 0 0 0 0 0 0 0 0 0 0 0 0 0 - - - - - 0 0 0 0 0 0 0 0 0 0 0 0 0 0 0 0 0 0 0 - 
- - 0 0 0 0 0 x x x 0 0 0 0 0 0 0 0 0 0 0 0 0 0 0 0 0 0 0 0 0 0 0 0 0 0 0 x x x 0 0 0 0 0 - 
- - 0 0 0 0 x x x x x 0 0 0 0 0 0 0 0 0 0 0 0 0 0 0 0 0 0 0 0 0 0 0 0 0 x x x x x x 0 0 0 - 
- - - 0 0 x x x x x x x 0 0 0 0 0 0 0 0 0 0 0 0 0 0 - - - 0 0 0 0 0 0 0 x x x x x x 0 0 0 - 
- - - 0 0 0 x x x x x 0 0 0 0 0 0 0 0 - - - - - - - - - - 0 0 0 0 0 0 0 0 x x x x 0 0 0 0 - 
- - - - 0 0 0 0 x x 0 0 0 0 0 0 0 0 0 - - - - - - - - - - 0 0 0 0 0 0 0 0 0 0 0 0 0 0 0 0 - 
- - - - 0 0 0 0 0 0 0 0 0 0 0 0 0 0 0 - - - - - - - - - - 0 0 0 0 0 0 0 0 0 0 0 0 0 0 0 0 - 
- - - - 0 0 0 0 0 0 0 0 0 0 0 0 0 0 0 0 - - - - - - - - - 0 0 0 0 0 0 0 0 0 0 0 0 0 0 0 0 0 
- - - - - 0 0 0 0 0 0 0 0 0 0 0 0 0 0 0 0 0 - - - - - - 0 0 0 0 0 0 0 0 0 0 b 0 0 0 0 0 0 0 
- - - - - 0 0 0 0 0 0 i 0 0 0 0 0 0 0 0 0 0 0 0 0 0 0 0 0 0 0 0 0 0 0 0 0 0 0 0 0 0 0 0 0 0 
- - - - - 0 0 0 0 0 0 0 0 0 0 0 0 0 0 0 0 0 0 0 0 0 0 0 0 0 0 0 0 0 0 0 0 0 0 0 0 0 0 0 0 0 
- - - - - - 0 0 0 0 0 0 0 0 0 0 0 0 0 0 0 0 0 0 0 0 0 0 0 0 0 0 0 0 0 0 0 0 0 0 0 0 0 0 0 0 
25 10 1 <-> 40 36 7
25 10 7 <-> 11 36 1
11 17 5 <-> 36 20 3
