3
0
0 0
35 35
x 0 0 0 0 0 0 0 0 0 0 0 0 0 0 0 0 0 0 0 0 0 0 0 0 0 0 0 0 0 0 0 0 0 x 
0 0 0 0 0 0 0 0 0 0 0 0 0 0 0 0 0 0 0 0 0 0 0 0 0 0 0 0 0 0 0 0 0 c 0 
0 0 0 0 0 0 0 0 0 0 0 0 0 0 0 0 0 0 0 0 0 0 0 0 0 0 0 0 0 0 0 0 0 0 0 
0 0 0 - - - - - - - - - - - - - 0 0 0 0 0 0 0 0 - - 0 0 0 0 0 0 0 0 0 
0 0 0 0 0 0 0 0 0 0 0 0 0 0 0 - 0 0 0 0 0 0 0 - 0 0 - 0 0 0 0 0 0 0 0 
0 0 1 3 2 0 0 0 0 0 0 0 0 c - 0 0 0 0 0 0 0 - 0 0 0 0 - 0 0 0 0 0 0 0 
0 0 3 1 3 0 0 0 0 0 0 0 0 - 0 0 0 0 0 0 0 - 0 0 0 0 0 0 - 0 0 0 0 0 0 
0 0 2 3 1 0 0 0 0 0 0 0 - 0 0 0 0 0 0 0 - 0 0 0 0 0 0 0 0 - 0 0 0 0 0 
0 0 0 0 0 0 0 0 0 0 0 - 0 0 0 0 0 0 0 - 0 0 0 0 2 1 3 0 0 0 - 0 0 0 0 
0 0 0 0 0 0 0 0 0 c - 0 0 0 0 0 0 0 - 0 0 0 0 0 1 2 1 0 0 0 0 - 0 0 0 
0 0 0 0 0 0 0 0 0 - 0 0 0 0 0 0 0 0 - 0 0 0 0 0 3 1 2 0 0 0 0 - 0 0 0 
0 0 0 0 0 0 0 0 - 0 0 0 0 0 0 0 0 0 0 - 0 0 0 0 0 0 0 0 0 0 - 0 0 0 0 
0 0 0 0 0 0 0 - 0 0 0 0 0 0 0 0 0 0 0 0 - 0 0 0 0 0 0 0 0 - 0 0 0 0 0 
0 0 0 0 0 0 - 0 0 0 0 0 0 0 0 0 0 0 0 0 0 - 0 0 0 0 0 0 - 0 0 0 0 0 0 
0 0 0 0 0 - 0 0 0 0 0 0 0 0 0 0 0 0 0 0 0 0 - 0 0 0 0 - 0 0 0 0 0 0 0 
0 0 0 0 - 0 0 0 0 0 0 0 0 0 0 0 0 0 0 0 0 0 0 - 0 0 - 0 0 0 0 0 0 0 0 
0 0 0 - - - - - - - - - - - - - 0 0 0 0 0 0 0 0 - - 0 0 0 0 3 2 1 0 0 
0 0 0 0 0 0 0 0 0 0 0 0 0 0 0 0 0 0 0 0 0 0 0 0 0 0 0 0 0 0 2 3 2 0 0 
0 0 0 0 0 0 0 0 0 0 0 0 0 0 0 0 0 0 0 0 0 0 0 0 c 0 0 0 0 0 1 2 3 0 0 
0 0 0 0 0 0 0 0 0 0 0 0 0 0 0 0 0 0 0 0 0 0 0 0 0 0 0 0 0 0 0 0 0 0 0 
0 0 0 0 0 0 0 0 0 0 0 0 0 0 0 0 c 0 0 0 0 0 0 0 0 0 0 0 0 0 0 0 0 0 0 
0 0 0 0 0 0 0 0 - - - - - 0 0 0 - 0 0 0 0 0 0 - 0 0 0 0 0 0 0 0 0 0 0 
0 0 0 0 0 0 0 - 0 0 0 0 0 0 0 0 - 0 0 0 0 0 - 0 0 0 0 0 0 0 0 0 0 0 0 
0 0 0 0 0 0 - 0 0 0 0 0 0 0 0 0 - 0 0 0 0 - 0 0 0 0 0 0 0 0 0 0 0 0 0 
0 0 0 0 0 - 0 0 0 0 0 0 0 0 0 0 - 0 0 0 - 0 0 0 0 0 - - 0 0 - - 0 0 0 
0 0 0 0 - 0 0 0 0 3 2 1 0 0 0 0 - 0 0 - 0 0 0 0 0 - 0 - 0 - x x - 0 0 
0 0 0 - 0 0 0 0 0 3 2 1 0 0 0 0 - 0 - 0 0 0 0 0 - 0 0 - 0 - x x - 0 0 
0 0 0 - 0 0 0 0 0 3 2 1 0 0 0 0 - - 0 0 0 0 0 0 0 0 0 - 0 0 - - - 0 0 
0 0 0 - 0 0 0 0 0 0 0 0 0 0 0 0 - 0 - 0 0 0 0 0 0 0 0 - 0 0 0 0 - 0 0 
0 0 0 0 - 0 0 0 0 0 0 0 0 0 0 0 - 0 0 - 0 0 0 0 0 0 0 - 0 0 0 0 - 0 0 
0 0 0 0 0 - 0 0 0 0 0 0 0 0 0 0 - 0 0 0 - 0 0 0 0 0 0 - 0 0 - - 0 0 0 
0 0 0 0 0 0 - 0 0 0 0 0 0 0 0 0 - 0 0 0 0 - 0 0 0 0 0 0 0 0 0 0 0 0 0 
0 0 0 0 0 0 0 - 0 0 0 0 0 0 0 0 - 0 0 0 0 0 - 0 0 0 0 0 0 0 0 0 0 0 0 
0 c 0 0 0 0 0 0 - - - - - 0 0 0 - 0 0 0 0 0 0 - 0 0 0 0 0 0 0 0 0 0 0 
x 0 0 0 0 0 0 0 0 0 0 0 0 0 0 0 0 0 0 0 0 0 0 0 0 0 0 0 0 0 0 0 0 0 x 
34 34 2 <-> 34 0 2
0 0 0 <-> 0 34 5
4 14 2 <-> 15 5 0
13 20 5 <-> 12 32 4
30 26 6 <-> 25 24 4
30 25 0 <-> 24 20 5
31 25 0 <-> 19 24 4
31 26 4 <-> 15 32 3
